111111111111111111111111111111111
1A1000000000000010000000000000001
101000100000000010000000000100001                          
10100010&000000010011111100100001                            
10000010111111001000+000000100001
1000001000+0000010000010000100001
101000100000100010000010000000001
101000-000001000-0000010111111001                            
1B1011111100101111110010000000001 
101000000000100000000010001000001           
10100010&000100010&00010001000001                            
1000001000+00000100000-000100+001                            
100000101111110010000000001000001                            
101000100000000010011111101000001                            
1010001000001000100000000010L0001                            
1C10001000+010&01000+010000000001                            
101000-000001000-000001000-000001                            
101011111100101111110010111111001                            
1000000000&010000000&010000000001                            
100000100000100010-00010000100001                           
101000100000000010000010000100001                            
1010001011111100100000000&010&001                           
1D1000100000000010000000000100001                            
1010001000+0100010011111100100001                            
1010000000001000100000+000010+001                           
1000111111001000-0000010000-00001                            
100000-00000101111110010000000001                            
1010001000&0100000000010000000001                            
10100010000010&01000&010111111001                            
1E1000100000000010000010000000001                            
101000000000000010000010000000001
100000000000000000000000000000001                           
111111111111111111111111111111111