11111111111111111111111111111111
1001000000000000100000000&000001
1001000000000000000000000+000001
1001000000000000100000000-000001
10A000000000000011111111111111&1
10010000000000001000000000000001
1001000000&00000000000000+000001
1001000000+00000000000000-000001
1001000000-000001000000000000001
10B000000000000011111111111111&1
10010000000000001000000000000001
10010000000000001000000000000001
1001000000&00000000000000+000001
1001000000+00000100000000-000001
1001000000-000000000000000000001
10C000000000000&L0111111111111*1
10010000000000000000000000000001
1001000000-000001000000000000001
1001000000&00000000000000+000001
1001000000+00000100000000-000001
10010000000000001000000000000001
10D000000000000011111111111111&1
10010000000000001000000000000001
1001000000000000000000000-000001
1001000000&00000000000000+000001
1001000000+000001000000000000001
100000000000000011111111111111&1
10010000000000001000000000000001
100100000000-000000000000-000001
1001000000000000000000000+000001
1001000000000000100000000&000001
10000000000000000000000000000001
11111111111111111111111111111111