111111111111111111111111111111111
1A00000000000000000000000000000B1
100111111111111111111111111111001
10000000000010000000000000000&001
111111100000100000000000000000001
100000000001100111111111111111111
100011111111100100000000000000001
1001100000000&0100000000000000001
1001100-0000000100100111111111001
10011000111110010010000-01000&001
10010000000010+100100000-11111001
1001110000001000001111-00000+1001
1000011111+01-0000100111111001001
10000010+100100100100100000001001
100011100100100100000100000001001
100000000100100100000111001111001
10000001010010+1111000000-0000001
100111110100100000100000000000001
100100000100100000111111111111111
1001000001-010010+000000-000000+1
1001001001001001000000000000&0001
1001+0100000100111111111111111001
100100100+001000-0000000000011001
1001001111111&0111000000000010001
100100000000000001111111110010011
10000000011110110+001000000010001
10000111000-101100001000000010001
100000010000100000001001111111001
100000010000111111001000000000001
111110000000000001001001100111001
100000000100000000000000000000001
1C00000111000010000000000000000D1
111111111111111111111111111111111