111111111111111111111111111111111
1A00000000000000000000000000000D1
1000000000000000&0000000000000001
100100111111111000111111111111001
10010+10000000-000000000000000001
10010010000000000000000+000000001
100100100111111111111111111111001
100100100+0000000-000000000001001
100100100000000000000000000001001
100100100111111111111111001001001
1001001-0100000000000001001001001
100100100100000&00000001001001001
1001001001001110001110010-1001001
100100100100100000-01001001001001
10010010+1001000000010010010+1001
10000010&000100111001001001000001
100000100000100010001001001000001
100000100000100010001001001000001
1001001001001+0000001001001001001
100100100100100000001001001001001
100100100100111111111001+01001001
10010010010000000-0000010010-1001
100100100100000000000001001001001
1001+0100111111000111111-01001001
100100000000000&+0000000001001001
100100000000000000000000001001001
100111111111111111111111001001001
100000000000000-00000000001001001
1000000000000000&000+000001001001
100111111111111000111111111001001
100000000000000-00000000000000001
1B00000000000000000000000000000C1
111111111111111111111111111111111


