11111111111111111111111111111111
10A00B00C00D0001000-000000&00001
10000000000000010000001000000001
10000000000000010000001000+00001
10000000000000010000001000-00001
10000000000000010000001000000001
10000000000000010000001000+00001
10000000000000010&000-1111111111
10000000000000&10000001000+00001
10000000000000010000001000000001
10000000000000010000001000-00001
10000000000000010000001000+00001
10000000000000010000001000000001
10000000000000000000001000000001
10000000000000000000000000&00001
111111111111100L0011111111111111
1000000&00000000000000000&000001
100000000000000-0000000000000001
1011111+111111010000001111111001
10100000000001010000001000000001
1010000&000001010000001000+00001
1010000-000001010000001000000001
10100000000001010000001000-00001
1011111+1111110100&0001000000001
10100000000001010000001000000001
1010000&000001010000001000+00001
1010000-000001010000001000000001
10100000000001010000001111111001
1011111+1111110100000000-0000001
10000000-0000001000&000000000001
11111111111111111111111111111111